Bank,Date,Title,Details,Category,Comment,Operation,Currency,Balance
Bank A,31/01/2021,Init money,,,init,"888,48",PLN,"888,48"
Bank A,01/02/2021,Italian restaurant,,,anniversary,"-38,26",PLN,"850,22"
Bank A,02/02/2021,Market A,,,,"-14,72",PLN,"835,50"
Bank A,03/02/2021,Netflix,,,,"-100,00",PLN,"735,50"
Bank A,04/02/2021,Canteen,,,,"-16,20",PLN,"719,30"
Bank A,05/02/2021,Salary,,,January salary,"1000,56",PLN,"1719,86"