"Numer rachunku/karty","Data transakcji","Data rozliczenia","Rodzaj transakcji","Na konto/Z konta","Odbiorca/Zleceniodawca","Opis","Obciążenia","Uznania","Saldo","Waluta"
"PL22 22 2222 2222 2222 2222 2222","2021-03-15","2021-03-15","ZAKUP - FIZ. UŻYCIE KARTY","","","Train ticket PKP","-21.78","","2178.36","PLN"
"PL22 22 2222 2222 2222 2222 2222","2021-03-08","2021-03-08","ZAKUP - BEZ FIZ. UŻYCIA KARTY","","","Spotify","-19.99","","2200.14","PLN"
"PL22 22 2222 2222 2222 2222 2222","2021-02-26","2021-02-26","PRZELEW WEWNĘTRZNY PRZYCHODZĄCY","11 11 1111 1111 1111 1111 11111 11","Jane Doe","Przelew","","50.00","2220.13","PLN"
"PL22 22 2222 2222 2222 2222 2222","2021-02-26","2021-02-26","PRZELEW PRZYCHODZĄCY","11 11 1111 1111 1111 1111 11111 11","John Doe","PENSJA","","1234.78","2170.13","PLN"
"PL22 22 2222 2222 2222 2222 2222","2021-02-25","2021-02-25","PŁATNOŚĆ BLIK W INTERNECIE","","pizzeria","Zamówienie pizzy","-64.90","","935.35","PLN"
"PL22 22 2222 2222 2222 2222 2222","2021-02-22","2021-02-22","PRZELEW WEWNĘTRZNY WYCHODZĄCY","11 11 1111 1111 1111 1111 11111 11","Jane Doe","Telefon","-69.00","","1000.25","PLN"
